####################
#--------------@@@-#
####---------@@@---#
#-----------@@@@@@@#
#@@@@######-@@@@####
#--@@---@@----@@@###
####----###---###--#
#------------------#
#@@@@----------@@@@#
###---#----#---##--#
#-----------@@@@@--#
#---^^^-^^^^^-^^---#
#^^^^^^-^^^^-------#
#-------------@@@@@#
#@@@@@@@@@-------^^#
#---@@@@---@@------#
#@@@@@@@@@@@@@@@@@-#
#------^^^^^@--^^^-#
#------------------#
####################